EVENHANDED
EVENNESSES
EVENTFULLY
EVENTUALLY
EVENTUATED
EVENTUATES
EVERDURING
EVERGLADES
EVERGREENS
EVERYPLACE
EVERYTHING
EVERYWHERE
EVERYWOMAN
EVERYWOMEN
